"filename", "language", "Dart", "comment", "blank", "total"
"/home/denisbueltan/Documents/VsCodeKeyboard/vsckeyboard/lib/common/class_functions/command_controller.dart", "Dart", 135, 0, 19, 154
"/home/denisbueltan/Documents/VsCodeKeyboard/vsckeyboard/lib/common/class_functions/default_command_groups.dart", "Dart", 38, 0, 4, 42
"/home/denisbueltan/Documents/VsCodeKeyboard/vsckeyboard/lib/common/class_functions/default_commands.dart", "Dart", 114, 0, 14, 128
"/home/denisbueltan/Documents/VsCodeKeyboard/vsckeyboard/lib/common/class_functions/default_vscodekeyboard.dart", "Dart", 116, 0, 4, 120
"/home/denisbueltan/Documents/VsCodeKeyboard/vsckeyboard/lib/common/class_functions/dropdown_controllers.dart", "Dart", 53, 0, 11, 64
"/home/denisbueltan/Documents/VsCodeKeyboard/vsckeyboard/lib/common/class_functions/grid_controller.dart", "Dart", 291, 7, 32, 330
"/home/denisbueltan/Documents/VsCodeKeyboard/vsckeyboard/lib/common/class_functions/ip_address_input.dart", "Dart", 82, 0, 17, 99
"/home/denisbueltan/Documents/VsCodeKeyboard/vsckeyboard/lib/common/class_functions/scroll_physics.dart", "Dart", 34, 0, 5, 39
"/home/denisbueltan/Documents/VsCodeKeyboard/vsckeyboard/lib/common/constants.dart", "Dart", 3, 0, 2, 5
"/home/denisbueltan/Documents/VsCodeKeyboard/vsckeyboard/lib/common/model/command_group_model.dart", "Dart", 74, 0, 9, 83
"/home/denisbueltan/Documents/VsCodeKeyboard/vsckeyboard/lib/common/model/command_model.dart", "Dart", 127, 0, 22, 149
"/home/denisbueltan/Documents/VsCodeKeyboard/vsckeyboard/lib/common/model/command_types.dart", "Dart", 176, 0, 16, 192
"/home/denisbueltan/Documents/VsCodeKeyboard/vsckeyboard/lib/common/model/grid_model.dart", "Dart", 16, 0, 2, 18
"/home/denisbueltan/Documents/VsCodeKeyboard/vsckeyboard/lib/common/services/http_request.dart", "Dart", 33, 0, 3, 36
"/home/denisbueltan/Documents/VsCodeKeyboard/vsckeyboard/lib/common/services/ws_connection.dart", "Dart", 90, 3, 11, 104
"/home/denisbueltan/Documents/VsCodeKeyboard/vsckeyboard/lib/common/utils.dart", "Dart", 0, 0, 1, 1
"/home/denisbueltan/Documents/VsCodeKeyboard/vsckeyboard/lib/common/widgets/button_ws.dart", "Dart", 85, 0, 4, 89
"/home/denisbueltan/Documents/VsCodeKeyboard/vsckeyboard/lib/common/widgets/footer_command_table.dart", "Dart", 68, 4, 4, 76
"/home/denisbueltan/Documents/VsCodeKeyboard/vsckeyboard/lib/common/widgets/grid_commands.dart", "Dart", 76, 1, 5, 82
"/home/denisbueltan/Documents/VsCodeKeyboard/vsckeyboard/lib/common/widgets/icon_command.dart", "Dart", 29, 0, 4, 33
"/home/denisbueltan/Documents/VsCodeKeyboard/vsckeyboard/lib/common/widgets/json_widget.dart", "Dart", 60, 0, 5, 65
"/home/denisbueltan/Documents/VsCodeKeyboard/vsckeyboard/lib/common/widgets/number_picker.dart", "Dart", 68, 0, 7, 75
"/home/denisbueltan/Documents/VsCodeKeyboard/vsckeyboard/lib/common/widgets/simple_dropdown.dart", "Dart", 76, 0, 10, 86
"/home/denisbueltan/Documents/VsCodeKeyboard/vsckeyboard/lib/common/widgets/slider_setting.dart", "Dart", 62, 16, 11, 89
"/home/denisbueltan/Documents/VsCodeKeyboard/vsckeyboard/lib/common/widgets/standard_button.dart", "Dart", 51, 0, 4, 55
"/home/denisbueltan/Documents/VsCodeKeyboard/vsckeyboard/lib/common/widgets/switch_setting.dart", "Dart", 74, 1, 7, 82
"/home/denisbueltan/Documents/VsCodeKeyboard/vsckeyboard/lib/common/widgets/tab_command_group.dart", "Dart", 48, 0, 4, 52
"/home/denisbueltan/Documents/VsCodeKeyboard/vsckeyboard/lib/common/widgets/tab_container.dart", "Dart", 180, 0, 11, 191
"/home/denisbueltan/Documents/VsCodeKeyboard/vsckeyboard/lib/common/widgets/toast.dart", "Dart", 46, 0, 3, 49
"/home/denisbueltan/Documents/VsCodeKeyboard/vsckeyboard/lib/features/0_home/ models/pages.dart", "Dart", 23, 0, 7, 30
"/home/denisbueltan/Documents/VsCodeKeyboard/vsckeyboard/lib/features/0_home/controllers/home_controller.dart", "Dart", 25, 0, 5, 30
"/home/denisbueltan/Documents/VsCodeKeyboard/vsckeyboard/lib/features/0_home/controllers/menu_controller.dart", "Dart", 24, 0, 10, 34
"/home/denisbueltan/Documents/VsCodeKeyboard/vsckeyboard/lib/features/0_home/views/menu.dart", "Dart", 249, 3, 11, 263
"/home/denisbueltan/Documents/VsCodeKeyboard/vsckeyboard/lib/features/0_home/views/page_panel.dart", "Dart", 53, 0, 5, 58
"/home/denisbueltan/Documents/VsCodeKeyboard/vsckeyboard/lib/features/1_keyboard/ models/button_properties.dart", "Dart", 125, 1, 14, 140
"/home/denisbueltan/Documents/VsCodeKeyboard/vsckeyboard/lib/features/1_keyboard/controllers/keyboard_buttons.dart", "Dart", 18, 0, 8, 26
"/home/denisbueltan/Documents/VsCodeKeyboard/vsckeyboard/lib/features/1_keyboard/controllers/main_controller.dart", "Dart", 118, 0, 19, 137
"/home/denisbueltan/Documents/VsCodeKeyboard/vsckeyboard/lib/features/1_keyboard/page_commands.dart", "Dart", 47, 0, 8, 55
"/home/denisbueltan/Documents/VsCodeKeyboard/vsckeyboard/lib/features/1_keyboard/views/command_button.dart", "Dart", 312, 0, 19, 331
"/home/denisbueltan/Documents/VsCodeKeyboard/vsckeyboard/lib/features/1_keyboard/views/keyboard_view.dart", "Dart", 134, 1, 10, 145
"/home/denisbueltan/Documents/VsCodeKeyboard/vsckeyboard/lib/features/1_keyboard/views/list_commands.dart", "Dart", 186, 0, 14, 200
"/home/denisbueltan/Documents/VsCodeKeyboard/vsckeyboard/lib/features/1_keyboard/views/slidable_btn_action.dart", "Dart", 129, 0, 9, 138
"/home/denisbueltan/Documents/VsCodeKeyboard/vsckeyboard/lib/features/2_keyboard_setting/controllers/keyboard_settings_controller.dart", "Dart", 237, 7, 41, 285
"/home/denisbueltan/Documents/VsCodeKeyboard/vsckeyboard/lib/features/2_keyboard_setting/controllers/session_debug_controller.dart", "Dart", 49, 1, 12, 62
"/home/denisbueltan/Documents/VsCodeKeyboard/vsckeyboard/lib/features/2_keyboard_setting/models/session_debug_model.dart", "Dart", 37, 0, 6, 43
"/home/denisbueltan/Documents/VsCodeKeyboard/vsckeyboard/lib/features/2_keyboard_setting/views/page_keyboard_settings.dart", "Dart", 273, 13, 13, 299
"/home/denisbueltan/Documents/VsCodeKeyboard/vsckeyboard/lib/features/3_key_settings/controllers/key_settings_controller.dart", "Dart", 178, 9, 27, 214
"/home/denisbueltan/Documents/VsCodeKeyboard/vsckeyboard/lib/features/3_key_settings/views/footer_assign_cmd.dart", "Dart", 51, 5, 3, 59
"/home/denisbueltan/Documents/VsCodeKeyboard/vsckeyboard/lib/features/3_key_settings/views/key_settings_page.dart", "Dart", 219, 0, 8, 227
"/home/denisbueltan/Documents/VsCodeKeyboard/vsckeyboard/lib/features/3_key_settings/views/name_text_field.dart", "Dart", 89, 0, 4, 93
"/home/denisbueltan/Documents/VsCodeKeyboard/vsckeyboard/lib/features/4_all_commands/views/page_all_commands.dart", "Dart", 146, 0, 3, 149
"/home/denisbueltan/Documents/VsCodeKeyboard/vsckeyboard/lib/main.dart", "Dart", 143, 3, 13, 159
"Total", "-", 5170, 75, 520, 5765